00000000000000000000
00000000000000000000
00000000000000000000
00000000000000000000
00000010100000000000
00000000001111100000
00000000001010000000
11111100000000100000
00001100000001000000
00000111111111111111
00000100000010000000
00000111111010000000
00000100001010011110
00000100101010110010
00000110001111100010
00000011111100000010
00000010000000000011
00000010000000000000
00000010000000000000
00000010000000000000
