00000000000000000000
01110011100010111110
01000010111110000010
01011000100011111010
00001111111010001000
00111000001000111110
01100000001101100100
00101111101000000100
01101000101001111110
00111101100000000100
01100101001111011100
01000001011000010000
11111101110101111111
00010000010111000000
01010010010001000010
01111111111101001010
01001010000111001010
01000010111100111010
01111000000100010010
00000000000000000000
