00000000000000000000
01111110111100111100
00000000100000000100
01110011100111100100
01000000000100100000
01001100000100100010
01000111100100101010
01110000000000101010
01010011111000101010
11010010001100111010
01011110000100000000
01000000000100000000
01111100010111111111
00000101010000000000
01110101010001000000
00000001011101011110
00101111010001000000
00100000010001110100
00111001110111100110
00000000000000000000
