01111110011100100100
01000010000100101110
11001011110111101000
01101000100100111100
00111100111101100100
01100111000001000110
01000001000111111010
01111101110100101010
01000100001101001100
01010111110001000100
00011100011111111100
01110001101000100110
01010110100010010010
01000101111111101000
01101101010000111100
00111101011010101111
01100111010010001000
01001000001010100110
01111111111111111010
01000110101101001110
