01111110000000000000
01111110010000111100
00011000010010100000
00011000010010100000
00011000010011100000
00011000011110000111
00011000010011011100
00011111110001010110
00000000010011111000
01100010010100000000
00100011111100000010
00111000000100011110
11101011111111110000
00001010001000010000
00000000001000001000
00000000001111111110
00000001000001000000
00000000000001000000
00000000000000000000
00000000000000000000
